20 20
####################
#.....S#G.........@#
#.....#.....@......#
#.....##.###########
#.....#............#
#..............@...#
#.....#............#
#.....#............#
#.....#............#
#.....##############
#.....#............#
#..............@...#
#.....#...@........#
##.######......@...#
#.....#............#
#.....#............#
#.....#...@........#
#.@...#............#
#...@.#.......@....#
####################